11111111111111111111
10001000000000111111
10000000010000000111
11011100010070000111
10000111110000070111
10000000019000000111
10000500011111111111
10700600000000000111
10000000000000000111
11111111111111060111
11111111111111000111
10701000000100000111
10000005010100500111
11111000010100000111
10010011110160111111
10010000010100000001
10011110010111111001
10000000010000003001
1000000001000002*401
11111111111111111111