11111111111111111111
190010000~0050111111
|0701000015000~00111
111~1050010000110111
10001~11110050110111
100000000100001|0111
|000070001~111110111
10050000016000110111
#0000000010000110|11
11111111111111110111
111111|1111111110111
106010000~00501|0111
#000~000010000110111
11X11000010500~00111
130000X1110000111111
140000000105000~0001
1200000001111111000#
10000005010000010001
1*0000000100000#0501
11#11111110000011111
