1111111XX11XXX111111
1767700|0|0000000001
17770000800000000001
1000000|0|0000000001
10000000000000000001
10000000000000000001
11111177000771111111
1111110|000|01111111
11111100000001111111
1111110|000|01111111
11111100000001111111
1111110|000|01111111
11111100000001111111
10000000000000000001
10000000000000000001
10000000000000000001
10000000000000000001
10000002340000000001
10000000*00000000001
11111111111111111111
