11111111111111111111
11100000|*|000000#71
11106|0023400|600111
16000000000000000111
11100000000000000#71
11106|0000000|600111
17000000000000000111
11100000605000000#71
11106|0000000|600111
17000000605000000111
11100000000000000#71
11106|0060500|600111
15000000000000000111
11100000605000000#71
11106|0X|#|X0|600111
1500000#660#00000111
11100XXX770XXX000#71
11|00~0077000#000|11
15000X0519150X000111
111111111#1111111111
