11111111111XXX111111
10|0|00|0000|00|0|01
10787000000000078701
10|0|00|0000|00|0|01
10000000000000000001
10000000000000000001
11#0117700077111#011
1100010|000|01100011
11000100000001100011
1111110|000|01111111
11000100000001100011
1100010|000|01100011
111#1100000001111#11
10000000000000000001
10000000000000000001
100|000000000000|001
10000000000000000001
10000002340000000001
10000000000000000001
11111111*11111111111
