11111111111111111111
1600|0000110000~0001
100010000110011|5001
11~11110011001010001
1001000001100101000#
100100000|1001011|11
10010000000051000001
1001000001|001005001
100|050001100|000001
100~0000911000000001
111111111111111~1111
1000000001|000000001
100000050~0005000001
100100100|1000005001
10000000011000000001
1001001001X005000001
10000200011001##1001
103000000X1001001001
1*004000011001001001
1111#111111111001111
