11111111111111111111
1600|0009110000~0001
100015000110011|5001
11~11110011001010001
1001000001100101000#
100100000|1001011|11
100100000~0051000001
100100000~0001005001
100|000001|00|000001
100~0000011000000001
111111111111111~1111
1000000001|000000001
100000050~0005000001
100100100~0000005001
100000000|1000000001
|001001001X005000001
10000200011001##1001
103000000X1001001001
#0004000011001001001
1111#111111111001111
