11111111111111111111
111000001*1000000#71
11100|0023400|000111
16000000000000000111
11100000000000000#71
11100|0000000|000111
17000000055000000111
11100000055000000#71
11100|0000000|000111
17000000000000000111
11100000000000000#71
11100|0000000|000111
15000000660000000111
11100000660000000#71
11100|0011100|000111
1500000#000#00000111
11100010770010000#71
11|00~0077000#000|11
15000100191001000111
11111111111111111111
