11111111111111111111
1*201060050005000111
1340~005000600070191
111X1111100111111101
1000000011007000100|
10000000001010015511
1000070011X100107711
100000000~0000117711
10001110011111001001
11~10101001111100101
110110110111111X0001
150011101111111X6011
1000000001111XXX0011
1111111X000110000011
190010911~11011~1111
1000|001000100005001
100010010001111|0001
1000|001000000110701
1000700#060000000001
11111111111111111111
