11111111111111111111
190010000~0050111111
|070~000015000~00111
11111050010000110111
10000011110050110111
100000000100001|0111
|000070001~111110111
10050000016000110111
#0000000010000110|11
11111111111111110111
111111|1111111110111
106010000~00501|0111
#000~000010000110111
11X11000010500~00111
100000X1110000111111
10000000010500000001
1000000001011111000#
12300005010000110001
1*400000010000000501
111111111111|1111111
