11111111111111111111
111000001*1000000#71
11106|0023400|600111
16000000000000000111
11100000000000000#71
11106|0000000|600111
17000000055000000111
11100000055000000#71
11106|0000000|600111
17000000000000000111
11100000000000000#71
11106|0000000|600111
15000000660000000111
11100000660000000#71
11106|0011100|600111
1500000#660#00000111
11100010770010000#71
11|00~0077000#000|11
15000105191501000111
11111111111111111111
