11111111111111111111
16001000011000000001
10001000011001115001
11011110011001010001
10010000011001010001
10010000011001011111
10010000000051000001
10010000011001005001
10000500011001000001
10000000911000000001
11111111111111101111
10000000011000000001
10000005000005000001
10010010011000005001
10000000011000000001
10010010011005000001
10000200011001001001
10300000011001001001
1*004000011001001001
11111111111111111111