11111111111111111111
1*201060050005000111
1340~005000600070191
111X1111100111111101
1000000011007000100|
10000000001010010011
1000070011X100100011
100000000~0000110011
10001110011111001001
11~10101001111100101
110110110111111X0001
150011101111111X6011
1000000001111XXX0011
1111111X000110000011
190010911011011~1111
1000|001000100005001
100010010001111|0001
1000|001000000110701
1000700#060000000001
10000001111111111111
