11111111111XXX111111
10|0|00|0000|00|0|01
10787000000000078701
10|0|00|0000|00|0|01
10000000000000000001
10000000000000000001
11#01X7700077X11#011
11000X0|000|0X100011
11000X0000000X100011
11111X0|000|0X111111
11000X0000000X100011
11000X0|000|0X100011
111#XX0000000XX11#11
10000000000000000001
10000000000000000001
100|000000000000|001
10000000000000000001
10000002340000000001
1000000|9|0000000001
11111111111111111111
