11111111111111111111
10001060000000000011
10050000000000070091
11111111100111111111
15000000000000000011
16000000000000000011
17000700170010000011
10000000100010000011
10000700100710000011
11111111101111110011
11111111101111110011
10001070000000110011
10000000000011110011
11111111000110000011
10000001111100111111
10000001000100000001
11107011000111110001
12300005000000110701
1*400005000000000001
11111111111111111111