11111111111111111111
18677000000000000001
17770000000000000001
17000000000000000001
10000000000000000001
10000000000000000001
11111177000771111111
11111101000101111111
11111100000001111111
11111101000101111111
11111100000001111111
11111101000101111111
11111100000001111111
10000000000000000001
10000000000000000001
10000000000000000001
10000000000000000001
10000002340000000001
10000000*00000000001
11111111111111111111